2 . 9|. 7 .|3 . 4
. 1 .|5 . 9|. 7 .
5 . 8|. 6 .|2 . 9
-----+-----+-----
. . .|. 3 .|. . .
7 . .|2 . 8|. . 1
. 8 .|. 9 .|. 4 .
-----+-----+-----
. . .|. . .|. . .
3 9 .|. 8 .|. 6 2
8 4 .|. . .|. 3 7
