--9  5--  2--
-8-  2--  7--
-1-  4--  3--

5--  -1-  --4
4--  ---  --9
3--  -6-  --8

--7  --8  -1-
--4  --3  -6-
--2  --9  8--
