6..1..5..
835......
......296
9.3.7....
.6.....3.
....5.8.4
481......
......745
..2..6..8
