. 7 .|9 . 6|. 4 .
4 . .|3 . 5|. . 7
. 5 .|. 2 .|. 1 .
-----+-----+-----
. . 8|. . .|6 . .
7 6 .|. . .|. 9 5
. . 1|. . .|3 . .
-----+-----+-----
. 3 .|. 4 .|. 8 .
6 . .|8 . 7|. . 9
. 8 .|2 . 3|. 5 .
