----3-596
--91-----
-754-----
36--2----
8-------2
----6--47
-----516-
-----83--
924-1----
