...  28.  4..
1..  6..  9..
5..  3..  6..

.6.  .1.  .5.
.3.  ...  .7.
.8.  .4.  .2.

..2  ..7  ..3
..4  ..2  ..1
..9  .65  ...
